111111111111111111111111111111
100000000000000000000000000001
1E00000000111000000011111111P1
100000001110000000111000011101
100000111011100000000001110001
1000111001110000C0001110000001
101111111111100001110000000001
100000011100000111000000000001
100000011100011111111000000001
1C00000000000000000000000000C1
111111111111111111111111111111