1111111111111
1001000P00001
100C00111C001
1P0011E000001
1111111111111