11111111
10000001
1000P001
10000001
10000001
1C0000E1
11111111