1111111111111111111
1P001111111111111E1
1000111111111111101
1000110000111111101
1000110100111111101
1000111110111111101
1000110000111111101
1000111111111111101
1000000000000000001
1000111111111111101
1000111111111111101
1000111111111111101
1000111111111111101
1C00111111111111101
1111111111111111111